7 10
##########
###      #
#   ###  #
# # ###  #
#        #
#     #  #
##########
