14 9
#########
##      #
## ###  #
#       #
#  ### ##
#       #
## ###  #
#       #
#  ###  #
#       #
######  #
#       #
##     ##
#########
