14 9
#########
##      #
## ## # #
## ## # #
#     # #
#  #### #
#  #### #
#  #### #
#  #### #
#       #
#  ###  #
#       #
#      ##
#########
