9 8
########
##     #
## ### #
## ### #
##     #
#   #  #
#      #
#      #
########
