6 18 D l 1 17 D u 4 3
##################
#                2
#                #
#                #
###3##############