11 26 D u 0 1
#-#                       
# #                       
# #                       
# ########################
#           #            #
#                        #
#          ###           #
#            #           #
#            ##          #
#                        #
##########################