11 26
# #                       
# #       # #             
# #       # #             
# ######### ##############
#           #            #
#                        #
#          ###           #
#            #           #
#            ##          #
#                        #
##########################