11 11 D l 2 10 D r 5 0 D u 10 7 
###########
#         #
#         2
#         #
#         #
4         #
#         #
#         #
#         #
#         #
#######3###