11 11
###########
#         #
#          
#         #
#         #
          #
#         #
#         #
#         #
#         #
####### ###