7 13 D u 6 8
#############
#           #
#   O       #
#           #
#           #
#           #
########3####
