6 8 D u 5 3
########
#      #
#      #
#      #
#      #
###3####