11 11 D d 0 5 D l 5 10 D u 10 5 D r 5 0
#####1#####
#         #
#         #
#         #
#         #
4         2
#         #
#         #
#         #
#         #
#####3#####