5  1  1  1  6  5  1  1  1  6
4  9  0  1  3  3  1  0  9  2
8  3  0  8  6  5  7  0  3  7
0  0  10 0  0  0  0  10 0  0
9  9  0  0  14 12 0  0  9  9
0  0  10 0  0  0  0  10 0  0
5  1  0  3  6  5  3  0  1  6
8  6  0  0  0  0  0  0  5  7
4  3  7  8  6  5  7  8  3  2
8  3  3  3  3  3  3  3  3  7
