12 17
#################
#               #
               ##
#             ## 
#            ##  
#            #   
#            #   
##           #   
 ##          ##  
  ##          ## 
   ##          # 
    ### ######## 