14 9
#########
#    ####
# #     #
# #   # #
#       #
###   # #
#       #
# #   # #
#   #   #
# #######
#   #####
### #####
#   #####
#########
