10 11
###########
#         #
#        ##
##        #
#    #    #
#    # ####  
###       #
#         #
#         #
###########
