13 10
##########
#  #     #
#     ## #
#     ## #
#        #
#   #  # #
# #      #
# # #  ###
# # #    #
#        #
# #### ###
#        #
##########
