14 10
##########
#   #    #
# # # ## #
# # # ## #
# # # ## #
# #      #
# ### #  #
# ### #  #
#        #
##### #  #
#        #
# ### # ##
#        #
##########
