12 9
#########
#     ###
# ### ###
#      ##
## ##   #
#     # #
#  ## # #
#     # #
#       #
#  #  ###
#  #    #
#########
